* *S* *
*-* *-*
|X X|X|
* * * *
|X|X X|
* *_* *
|X X|X|
*_* *_*
* *E* *
